11111111111
10C00F00001
10000P0CFF1
10C00C000E1
11111111111
