11111111111
10110110001
10110111101
10000110001
11110110111
11110110001
11111111111