1111111111
1CCFCCCCC1
1PCCFFFFF1
1CCCCCCEE1
1111111111