111111111111
1CC1P0011111
1C11F00C1111
1C1F010CC111
1CFF11ECCC11
111111111111
