1111111111
100000000E
1011111111
10CC0F00C1
1111111F01
1P000CC001
1111111111