11111111
11110001
11F10101
111100E1
11111111