1111111111111
10000C00FF001
1011111C111C1
10111P1CCC111
1CFF001FE1111
1111111111111