111111111
100011111
111111111
111000011
111011011
111000011
111111111
