111111111111
1C1000000011
1C1000C00101
1C0P00000011
1CE001000001
111111111111