111111
1CP111
100001
101101
101E11
100001
111111