1111111111111
10F0F00010CC1
100CP00110CC1
10CFFF1100CC1
100FE11000CC1
100FFF0000CC1
1111111111111