1111111111
100P000001
10000F0C01
1111111111
