111111111111
101000000F11
101CF00001F1
100PF00FFF11
10E0F1000001
111111111111