111111111
1000000F1
100111111
1000000F1
111111111
