11111111111111111111111
10C00F0000110C0C0C0C0C1
10000P0CFF110C0C0C0C0C1
10C00C000C110C0C0C0C0C1
1CCCCCCCCC0F0C0C0C0C0C1
1CCCCCCCCC110C0C0C0C0C1
1CCCCCCCCC110C0C0C0C0C1
1CCCCCCCCC110C0C0C0C0C1
1CCCCCCCCC110C0C0C0C0C1
11111111111111111111111
