11111111111111111111111
11100000000000000000001
1E0P000CCCCCC0000000001
110CCCCC00000CCCCC00001
100CCCCC000000000C00001
100CCCCC000000000C000E1
1000000000000CCCCC00001
10000000000000000000001
10000000000000000000E01
11111111111111111111111
