1111111111
1PC1111111
1CC01F1111
10F0000E11
10011CC111
1111111111