1111111111
1CP111C111
1000001011
1011110111
101E111111
1FF0000001
1111111111