1111111111
1CCCCFF001
1000P00001
10000000E1
1111111111