11111111111111111111111
1C1C1C1C1C1C1C1C1C1C1C1
1C1C1C1C1C1C1C1C1C1C1C1
1C1C1C1C1C1C1C1C1C1C1C1
1C1C1C1C1C1P1C1C1C1C1C1
1C1C1C1C1C1F1C1C1C1C1C1
1C1C1C1C1C1F1C1C1C1C1C1
1C1C1C1C1C1F1C1C1C1C1C1
1C1C1C1C1C1F1C1C1C1C1C1
11111111111111111111111
