1111111
1CP0001
101E001
1010001
1111111