1111111111111
1000000010CC1
1000P00110CC1
10C0001100CC1
1000E11000CC1
1000000000CC1
1111111111111