11111111
11110001
11FCCCC1
11110E01
11111111