111111111111
100000P00011
100000C00101
10000E000011
100001000001
111111111111